R 920 600
NO ./texture/wall_texture/wood_wall.xpm
SO ./texture/wall_texture/wood_wall2.xpm
WE ./texture/wall_texture/dalles.xpm
EA ./texture/wall_texture/red_brick.xpm
S ./texture/sprite/pillar.xpm
F 0,255,0
C 0,245,255

    11111111111111111111111111111
    10000000000000000000000000001
    10122111111111110000000000201
11111000000000000000000000001111
10001020000000000000000000101
10001020001111111111111110101
1000100200101 100000000010111
100010000010111000000000101
10101000001000100000000010111
10101000000001100000000010001
10001000001000000000000000001
10101000000111111111111111111
1010100010W1 1000000000000201
111111111111 1111111111111111
